MovesAllowed: 500
##########
#00000000#
#00000000#
#00000000#
#00000000#
#00000000#
#00000000#
#000@0000#
#00000000#
##########