MovesAllowed: 500
##############
#000000000000#
#000000000000#
#000000000000#
#000000000000#
#000000000000#
#000000000000#
#000@00000100#
#000000000000#
##############